Hd, Hd, Hd, Hd, Hd, Dd, Dd, Dd, Hd, Hd, Hd, Hd, Dd, Dd, Dd, Dd, Dd, Dd, Dd, Dd, Hd, Dd, Hd, Hd, Hd, Hd, Hd
Hhd, Hd, Hhd, Ds, Dd, Dd, Dd, Hd, Dd, Hd, Dd, Dd, Dd, Dd, Dd, Dd, Dd, Dd, Dd, Dd, Hd, Hd, Dd, Hd, Dd, Dd, Dd
Hhd, Hhd, Hhd, Dd, Dd, Dd, Dd, Dd, Dd, Dd, 3 Dd, Dd, Hhd, Mdd, Mdd, Dd, Dd, Hhd, Hhd, Dd, Dd, Dd, Dd, Dd, Hhd, Dd, Dd
Dd, Mdd, Mdd^Es, Dd, Dd, Hhd, Hhd, Hhd, Dd, Dd, Dd, Ds, Hhd, Mdd, Hhd, Hhd, Ds^Es, Hhd, Dd^Es, Dd, Hhd, Dd, Ds^Es, Hhd, Hhd, Dd, Dd
Dd, Mdd, Ds^Es, Ds^Es, Hhd, Mdd, Mdd, Mdd, Hhd, Dd, Dd^Es, Hhd, Hhd, Hhd, Mdd, Hhd, Mdd, Ds^Es, Mdd, Hhd, Mdd, Hhd, Ds^Es, Ds, Dd, Dd, Hhd
Mdd, Dd, Mdd, Hhd, Mdd, Mdd, Xue, Mdd, Xue, Rd, Xue, Mdd, Mdd, Mdd, Mdd, Mdd, Mdd, Mdd, Mdd^Xm, Mdd, Mdd, Mdd, Hhd, Dd, Hhd, Hhd, Hhd
Mdd, Mdd, Mdd, Mdd, Mdd, Xue, Xue, Xue, Uhe, Rd, Dd, Xue, Xue, Xue, Mdd^Xm, Mdd^Xm, Mdd^Xm, Mdd^Xm, Mdd^Xm, Mdd^Xm, Mdd^Xm, Mdd, Mdd, Hhd, Mdd, Hhd, Hhd
Xue, Mdd, Xue, Mdd, Xue, Xue, Xue, Xue, Uhe, Rd^Es, Rd, Mdd, Xue, Xue, Mdd^Xm, Mdd^Xm, Mdd^Xm, Xue, Xue, Mdd^Xm, Mdd^Xm, Mdd^Xm, Mdd, Mdd, Mdd, Mdd, Dd
Xue, Xue, Xue, Xue, Xue, Xue, Xue, Xue, Mdd, Dd, Dd, Rd, Rd^Es, Uhe, Mdd, Mdd, Mdd, Rd, Rd, Xue, Xue, Mdd^Xm, Mdd^Xm, Mdd, Mdd, Mdd, Dd
Xue, Xue, Xue, Xue, Xue, Xue, Xue, Mdd, Mdd, Mdd, Xue, Uhe, Mdd, Uue, Dd, Dd, Dd, Uue, Rd^Es, Xue, Xue, Xue, Xue, Mdd, Mdd, Mdd, Dd
Xue, Xue, Xue, Xue, Xue, Xue, Xue, Xue, Xue, Xue, Xue, Mdd, Xue, Uhe, Uhe, Uhe, Xue, Rd^Es, Dd^Es, Rd, Dd, Xue, Xue, Mdd, Mdd, Mdd, Mdd
Xue, Xue, Xue, Xue, Xue, Xue, Xue, Xue, Mdd, Xue, Mdd, Xue, Xue, Xue, Xue, Xue, Xue, Xue, Xue, Rd, Dd, Xue, Xue, Xue, Mdd, Mdd, Mdd
Xue, Xue, Xue, Xue, Xue, Xue, Xue, Xue, Mdd, Mdd, Xue, Xue, Xue, Xue, Uhe, Xue, Xue, Uhe, Re^Es, Re, Xue, Xue, Xue, Xue, Xue, Xue, Xue
Xue, Xue, Xue, Xue, Tb^Tf, Uhe^Emf, Uhe, Xue, Uue, Mdd, Uhe, Uhe, Xue, Uhe, Uhe, Xue, Xue, Uhe, Uue^Es, Uhe, Mdd, Xue, Xue, Xue, Xue, Xue, Xue
Xue, Xue, Xue, Xue, Tb^Tf, Tb^Tf, Uue^Es, Uue, Uhe, Uue^Es, Uue^Es, Re^Vu, Re, Uue, Uue, Xue, Xue, Mdd, Uue, Uhe, Re^Vu, Xue, Xue, Xue, Xue, Xue, Xue
Xue, Xue, Xue, Xue, Xue, Re, Xue, Xue, Xue, Xue, Xue, Uhe, Uhe, Uhe, Xue, Uue^Es, Re^Es, Xue, Xue, Uue, Uhe, Uue, Uue, Uue, Uue, Uue, Uue
Uue, Re, Re, Uue, Re^Es, Uue^Es, Uue^Es, Re, Tb^Tf, Xue, Uue^Emf, Xue, Xue, Xue, Xue, Xue, Uhe, Uhe, Xue, Xue, Xue, Xue, Xue, Xue, Xue, Xue, Xue
Xue, Xue, Xue, Xue, Xue, Xue, Xue, Xue, Xue, Tb^Tf, Xue, Uue, Uue, Xue, Xue, Xue, Xue, Xue, Xue, Xue, Xue, Xue, Xue, Xue, Xue, Xue, Xue
Xue, Xue, Xue, Xue, Tb^Tf, Re, Uhe, Xue, Xue, Xue, Xue, Xue, Xue, Uue, Uhe, Uhe, Uhe, Xue, Xue, Xue, Xue, Xue, Xue, Xue, Xue, Xue, Xue
Xue, Xue, Xue, Xue, Tb^Tf, Uue, Uue^Es, Xue, Xue, Xue, Tb^Tf, Xue, Xue, Xue, Uhe, Uhe, Uhe, Xue, Xue, Xue, Xue, Xue, Xue, Xue, Xue, Xue, Xue
Xue, Xue, Xue, Xue, Uhe, Mdd, Uhe^Es, Uue^Vu, Xue, Tb^Tf, Tb^Tf, Xue, Xue, Xue, Xue, Uhe, Xue, Xue, Xue, Xue, Xue, Xue, Xue, Xue, Xue, Xue, Xue
Xue, Xue, Xue, Xue, Xue, Xue, Xue, Re^Es, Uue, Tb^Tf, Xue, Xue, Uhe, Xue, Xue, Xue, Xue, Xue, Xue, Xue, Xue, Xue, Xue, Xue, Xue, Xue, Xue
Xue, Xue, Xue, Xue, Xue, Xue, Tb^Tf, Uhe^Emf, Uhe, Uue^Emf, Re^Emf, Uue, Re^Emf, Uhe, Uue^Es, Uue, Uue, Xue, Xue, Xue, Cte, Xue, Xue, Xue, Xue, Xue, Xue
Xue, Xue, Xue, Xue, Xue, Xue, Xue, Xue, Xue, Xue, Tb^Tf, Tb^Tf, Tb^Tf, Re^Es, Uue, Uue, Xue, Xue, Re, Cte, 2 Kte, Cte, Uue, Xue, Xue, Xue, Xue
Xue, Xue, Xue, Xue, Xue, Xue, Xue, Xue, Xue, Xue, Xue, Wog, Wog, Wog, Wog, Wog, Wog, Xue, Uue, Cte, Cte, 1 Cte, Re, Xue, Xue, Xue, Xue
Xue, Xue, Xue, Xue, Xue, Xue, Xue, Xue, Xue, Xue, Xue, Xue, Xue, Wog, Xue, Wog, Wog, Wwg, Uue, Re, Uue, Re, Re, Uue^Vu, Uue, Xue, Uue
Xue, Xue, Xue, Xue, Xue, Xue, Xue, Xue, Xue, Xue, Xue, Xue, Xue, Xue, Xue, Wwg, Wwg, Wog, Wwg, Uue, Wwg, Uue, Xue, Uue, Uue, Uue, Xue
Xue, Xue, Xue, Xue, Xue, Xue, Xue, Xue, Xue, Xue, Xue, Xue, Xue, Xue, Xue, Xue, Wwg, Wwg, Wwg, Wwg, Wwg, Wwg, Xue, Xue, Xue, Xue, Xue
Xue, Xue, Xue, Xue, Xue, Xue, Xue, Xue, Xue, Xue, Xue, Xue, Xue, Xue, Xue, Xue, Xue, Wwg, Xue, Wwg, Wwg, Wwg, Wwg, Xue, Xue, Xue, Xue
Xue, Xue, Xue, Xue, Xue, Xue, Xue, Xue, Xue, Xue, Xue, Xue, Xue, Xue, Xue, Xue, Xue, Xue, Xue, Xue, Xue, Wwg, Wwg, Wwg, Wwg, Xue, Wwg
Xue, Xue, Xue, Xue, Xue, Xue, Xue, Xue, Xue, Xue, Xue, Xue, Xue, Xue, Xue, Xue, Xue, Xue, Xue, Xue, Xue, Xue, Xue, Wwg, Wwg, Wwg, Wwg
