Hd, Hd, Hd, Hd, Hd, Dd, Dd, Dd, Hd, Hd, Hd, Hd, Dd, Dd, Dd, Dd, Dd, Dd, Dd, Dd, Hd, Dd, Hd, Hd, Hd, Hd, Hd
Hhd, Hd, Hhd, Ds, Dd, Dd, Dd^Edp, Hd, Dd, Hd, Dd, Dd, Dd, Dd, Dd, Dd, Dd, Dd, Dd, Dd, Hd, Hd, Dd, Hd, Dd, Dd, Dd
Hhd, Hhd, Hhd, Dd, Dd, Dd, Dd, Dd, Dd, Dd, 3 Dd, Dd, Hhd, Mdd, Mdd, Dd^Edp, Dd, Hhd, Hhd, Dd^Edp, Dd, Dd, Dd, Dd, Hhd, Dd, Dd
Dd, Mdd, Mdd^Es, Dd, Dd, Hhd, Hhd, Hhd, Dd^Es, Dd, Dd, Ds, Hhd, Mdd, Hhd, Hhd, Ds^Es, Hhd, Dd^Es, Dd, Hhd, Dd, Ds^Es, Hhd, Hhd, Dd, Dd
Dd, Mdd, Ds^Es, Ds^Es, Hhd, Mdd, Mdd, Mdd, Dd^Es, Dd, Dd^Es, Hhd, Hhd, Hhd, Mdd, Hhd, Mdd, Ds^Es, Mdd, Hhd, Mdd, Hhd, Ds^Es, Ds, Dd, Dd, Hhd
Mdd, Dd, Mdd, Hhd, Mdd, Mdd, Xue, Mdd, Xue, Rd, Xue, Mdd, Mdd, Mdd, Mdd, Mdd, Mdd, Mdd, Mdd^Xm, Mdd, Mdd, Mdd, Hhd, Dd, Hhd, Hhd, Hhd
Mdd, Mdd, Mdd, Mdd, Mdd, Xue, Xue, Xue, Uhe, Uue, Uue, Xue, Xue, Xue, Mdd^Xm, Mdd^Xm, Mdd^Xm, Mdd^Xm, Mdd^Xm, Mdd^Xm, Mdd^Xm, Mdd, Mdd, Hhd, Mdd, Hhd, Hhd
Xue, Mdd, Xue, Mdd, Xue, Xue, Xue, Xue, Uhe, Uue, Rd, Mdd, Xue, Xue, Mdd^Xm, Mdd^Xm, Mdd^Xm, Xue, Xue, Mdd^Xm, Mdd^Xm, Mdd^Xm, Mdd, Mdd, Mdd, Mdd, Dd
Xue, Xue, Xue, Xue, Xue, Xue, Xue, Xue, Mdd, Dd^Es, Rd^Es, Uue, Uue, Uhe, Mdd, Mdd, Mdd, Uue, Uue, Xue, Xue, Mdd^Xm, Mdd^Xm, Mdd, Mdd, Mdd, Dd
Xue, Xue, Xue, Xue, Xue, Xue, Xue, Mdd, Mdd, Mdd, Xue, Rd, Mdd, Dd^Edb, Rd^Edb, Rd^Edb, Rd, Dd, Uue, Xue, Xue, Xue, Xue, Mdd, Mdd, Mdd, Dd
Xue, Xue, Xue, Xue, Xue, Xue, Xue, Xue, Xue, Xue, Xue, Mdd, Xue, Uhe^Edb, Uhe, Uue, Xue, Uhe, Rd, Uhe, Uhe, Xue, Xue, Mdd, Mdd, Mdd, Mdd
Xue, Xue, Xue, Xue, Xue, Xue, Xue, Xue, Mdd, Xue, Mdd, Xue, Xue, Xue, Xue, Xue, Xue, Xue, Xue, Rd, Dd, Xue, Xue, Xue, Mdd, Mdd, Mdd
Xue, Xue, Xue, Xue, Xue, Xue, Xue, Xue, Uhe, Mdd, Re, Xue, Xue, Xue, Uhe, Xue, Xue, Uhe, Uhe, Uue^Edb, Mdd, Xue, Xue, Xue, Xue, Xue, Xue
Xue, Xue, Xue, Xue, Uhe, Uhe, Uue, Xue, Uue, Xue, Uue, Uue, Uue^Edb, Uhe, Uhe, Xue, Xue, Uhe, Dd, Rd^Edb, Dd^Es, Mdd, Xue, Xue, Xue, Xue, Xue
Xue, Xue, Xue, Xue, Uhe, Uue, Re, Re, Re, Uue^Es, Uue^Edb, Re^Vu, Re^Edb, Re^Edb, Re^Edb, Xue, Xue, Uue, Rd, Rd, Rd, Mdd, Xue, Xue, Xue, Xue, Xue
Xue, Xue, Xue, Xue, Uue, Uue, Uhe, Xue, Xue, Xue, Xue, Uhe, Xue, Uue, Uue, Uue, Uue, Xue, Xue, Uhe, Mdd, Dd^Es, Uue, Uhe, Uue, Uue, Uue
Xue, Xue, Xue, Xue, Xue, Uue, Xue, Xue, Xue, Xue, Xue, Xue, Xue, Xue, Mdd, Uue^Emf, Uue, Uue, Xue, Mdd, Mdd, Xue, Xue, Xue, Xue, Xue, Xue
Xue, Xue, Xue, Xue, Uue, Xue, Uue, Xue, Xue, Xue, Xue, Xue, Xue, Xue, Mdd, Mdd, Mdd, Xue, Xue, Xue, Xue, Xue, Xue, Xue, Xue, Xue, Xue
Xue, Xue, Xue, Xue, Uue, Uue, Uue, Uhe, Xue, Xue, Uue, Xue, Uhe, Xue, Xue, Mdd, Xue, Xue, Xue, Xue, Xue, Xue, Xue, Xue, Xue, Xue, Xue
Xue, Xue, Xue, Xue, Xue, Uue, Re^Edb, Uhe^Edb, Re, Uue, Uhe, Re, Uue, Xue, Xue, Mdd, Xue, Xue, Xue, Xue, Xue, Xue, Xue, Xue, Xue, Xue, Xue
Xue, Xue, Xue, Xue, Xue, Uue, Uue, Re^Edb, Xue, Xue, Xue, Xue, Uue, Xue, Xue, Xue, Xue, Xue, Xue, Xue, Xue, Xue, Xue, Xue, Xue, Xue, Xue
Xue, Xue, Xue, Xue, Xue, Xue, Xue, Re^Edb, Uhe^Edb, Xue, Uhe, Xue, Re^Edb, Uhe, Xue, Xue, Xue, Xue, Xue, Xue, Xue, Xue, Xue, Xue, Xue, Xue, Xue
Xue, Xue, Xue, Xue, Xue, Xue, Uhe, Uue, Uue, Uhe, Re, Uue, Re^Edb, Re^Edb, Uue, Uue, Uue, Xue, Xue, Xue, Cte, Xue, Xue, Xue, Xue, Xue, Xue
Xue, Xue, Xue, Xue, Xue, Xue, Xue, Xue, Xue, Uue, Xue, Uue, Uue^Emf, Uue^Em, Uue, Uue, Xue, Xue, Uue, Cte, 2 Kte, Cte, Uhe, Xue, Xue, Xue, Xue
Xue, Xue, Xue, Xue, Xue, Xue, Xue, Xue, Xue, Xue, Xue, Tb^Tf, Tb^Tf, Tb^Tf, Wwg, Wwg, Xue, Xue, Uue, Cte, Cte, 1 Cte, Re^Emf, Xue, Xue, Xue, Xue
Xue, Xue, Xue, Xue, Xue, Xue, Xue, Xue, Xue, Xue, Xue, Tb^Tf, Xue, Tb^Tf, Xue, Wog, Wog, Xue, Uue, Re, Uue, Re^Em, Re^Emf, Uue^Vu, Uue^Em, Xue, Uue
Xue, Xue, Xue, Xue, Xue, Xue, Xue, Xue, Xue, Xue, Xue, Xue, Xue, Xue, Xue, Wwg, Wwg, Wog, Wwg^Es, Uue, Wwg^Es, Uue, Xue, Uhe, Uhe, Uue, Xue
Xue, Xue, Xue, Xue, Xue, Xue, Xue, Xue, Xue, Xue, Xue, Xue, Xue, Xue, Xue, Xue, Wwg, Wwg, Wwg, Wwg, Wog, Wwg, Xue, Xue, Xue, Xue, Xue
Xue, Xue, Xue, Xue, Xue, Xue, Xue, Xue, Xue, Xue, Xue, Xue, Xue, Xue, Xue, Xue, Xue, Wwg, Xue, Wog, Wog, Wwg, Wwg, Xue, Wwg, Xue, Xue
Xue, Xue, Xue, Xue, Xue, Xue, Xue, Xue, Xue, Xue, Xue, Xue, Xue, Xue, Xue, Xue, Xue, Xue, Xue, Wwg, Wwg, Wwg, Wwg, Wwg, Wwg, Wwg, Wwg
Xue, Xue, Xue, Xue, Xue, Xue, Xue, Xue, Xue, Xue, Xue, Xue, Xue, Xue, Xue, Xue, Xue, Xue, Xue, Wwg, Xue, Xue, Xue, Xue, Xue, Xue, Xue
