Dd, Dd, Dd, Dd, Dd^Esd, Dd^Esd, Hd, Hd, Hd, Dd, Hd, Dd, Hd, Hd, Dd^Ftd, Dd^Ftd, Dd^Ftd, Dd, Dd, Dd, Rd
Dd, Dd, Dd, Dd, Dd, Dd, Dd, Hd, Dd, Hd, Hd, Hd, Dd^Ftd, Hd, Rd, Rd, Rd, Rd, 3 Rd, Rd, Dd
Rd, Rd, Rd, Rd, Rd, Rd, Rd, Rd, Rd, Dd, Dd^Vda, Dd^Ftd, Rd, Rd, Hd, Dd, Hd, Dd, Dd, Dd^Ftd, Dd
Hd, Dd, Hd, Dd, Hd, Dd, Hd, Dd^Dc, Rd, Dd, Dd, Dd, Rd, Dd^Ftd, Dd, Hd, Hd, Hd, Hd, Hd, Hd
Mdd, Hd, Hd, Hd, Hd, Hd, Dd, Dd, Dd, Rd, Rd, Rd, Dd, Dd, Dd^Ftd, Hd, Dd^Ftd, Hd, Mdd, Mdd, Mdd
Mdd, Mdd, Hd, Hd, Hd, Hd, Dd, Dd, Dd, Dd, Dd, Dd, Dd, Dd, Dd^Esd, Dd^Ftd, Dd^Fts, Dd^Fts, Hd, Mdd, Mdd
Hd, Hd, Dd^Edp, Dd^Esd, Dd, Dd, Dd, Dd, Dd, Hhd, Hhd, Hhd, Dd, Ds, Hhd, Dd, Dd^Fts, Dd^Fts, Dd^Ftd, Hd, Dd
Dd, Hd, Dd, Dd, Dd^Ftd, Dd^Ftd, Dd, Ds, Hhd, Hhd, Hhd, Ds, Ds, Hhd, Hhd, Ds, Ds, Dd^Fts, Dd^Ftd, Hd, Dd^Esd
Dd, Dd, Dd, Dd, Dd, Dd^Fts, Ds, Re, Re, Sm, Sm, Sm, Re, Hhd, Sm, Re, Ds, Dd, Dd^Ftd, Dd, Dd
Hd, Hd, Hd, Hd, Dd, Dd, Dd, Ds, Hhd, Hhd, Re, Sm, 2 Wwt, Sm, Hhd, Re, Hhd, Dd, Dd, Dd, Dd
Hd, Hd, Hd, Dd, Dd^Fts, Ds, Dd, Hhd, Hhd, Hhd, Sm, Wwt, Sm, Re, Hhd, Hhd, Dd, Dd, Dd, Dd, Dd
Dd, Hd, Dd, Dd^Ftd, Dd^Fts, Dd^Fts, Dd, Dd, Hhd, Re, Sm, Sm, Sm, Hhd, Hhd, Dd, Ds, Dd, Hd, Hd, Dd
Dd, Dd^Edp, Dd, Dd, Dd^Ftd, Dd^Vdr, Dd, Dd, Ds, Re, Re, Re, Re, Hhd, Dd, Dd, Ds, Dd^Edp, Dd, Hd, Dd
Dd, Dd, Dd, Dd, Dd, Dd, Dd^Esd, Ds, Dd, Re, Hhd, Hhd, Ds, Ds, Dd, Dd, Dd, Dd, Dd^Ftd, Dd, Dd
Hd, Hd, Hd, Hd, Hd, Hd, Hd, Dd, Hd, Dd, Dd, Hhd, Dd, Ds, Dd, Dd, Dd, Dd^Vdr, Dd, Dd, Dd
Dd, Hd, Dd, Hd, Hd, Hd, Hd, Hd, Hd, Hd, Dd, Dd^Esd, Dd^Esd, Dd^Esd, Dd, Dd, Hd, Dd, Dd, Dd, Dd^Esd
Dd, Dd, Dd, Dd, Dd, Dd, Dd, Dd, Dd, Dd, Dd, Dd, Hd, Hd, Hd, Hd, Hd, Hd, Hd, Hd, Hd
Dd, Dd, Dd, Dd, Dd, Dd, Dd^Esd, Dd, Dd, Dd, Dd, Dd, Hd, Hd, Hd, Hd, Hd, Hd, Hd, Hd, Hd
Dd, Dd, Dd^Esd, Dd, Dd, Dd, Dd, Dd, Dd, Dd^Edpp, Dd, Dd, Dd, Dd, Dd, Dd, Dd^Esd, Hd, Dd, Hd, Hd
Dd, Dd, Hd, Hd, Hd, Dd, Hd, Dd, Hd, Dd^Esd, Dd, Dd, Dd, Dd, Dd, Dd, Dd^Dc, Dd, Dd, Dd, Dd
Dd, Dd, Dd, Hd, Hd, Hd, Hd, Hd, Hd, Hd, Hd, Dd, Dd, Dd, Dd, Dd, Dd, Dd, Dd, Dd, Dd
Dd^Edpp, Dd, Dd, Dd^Esd, Dd, Dd, Dd^Edb, Dd^Vdt, Dd^Edb, Dd, Dd, Dd, Dd, Dd, Dd^Esd, Dd, Dd, Dd, Dd, Dd, Dd
Hd, Hd, Dd, Dd, Dd, Dd, Dd, Dd^Edb, Dd^Edp, Dd, Dd, Dd, Hd, Hd, Hd, Dd, Hd, Dd, Dd, Dd, Dd
Hd, Hd, Hd, Hd, Hd, Dd, Hd, Dd, Hd, Dd, Dd, Dd, Dd, Hd, Dd^Edp, Hd, Hd, Hd, Hd, Hd, Hd
Dd^Edp, Hd, Hd, Hd, Hd, Hd, Hd, Hd, Hd, Hd, Hd, 1 Dd, Dd, Dd, Dd^Esd, Hd, Dd, Hd, Hd, Hd, Hd
Dd, Dd, Dd, Dd, Dd, Hd, Dd, Hd, Dd, Hd, Dd, Dd^Esd, Dd, Dd, Dd, Dd, Dd, Dd, Dd, Dd, Dd^Esd
Dd, Dd^Dc, Dd, Dd, Dd, Dd, Dd, Dd, Dd, Dd, Dd, Dd, Dd, Dd, Dd, Dd, Dd, Dd, Dd, Dd, Dd
