Xos, Xos, Xos, Xos, Xos, Xos, Xos, Xos, Icn, Xos, Xos, Xos, Xos, Xos, Xos, Xos, Xos
Xos, Xos, Xos, Xos, Xos, Xos, Xos, Xos, Icn^Pw|o, Xos, Xos, Xos, Xos, Xos, Xos, Xos, Xos
Xos, Xos, Uue, Rd, Ior^Edt, Rd^Edt, Rd, Xos^Efs, Ior, Xos^Efs, Ior, Ior, Ior, Ior, Ior, Xos, Xos
Xos, Xos, Ior, Ior, Ior, Ior, Ior, Ior, Ior, Ior, Ior^Es, Ior, Ior, Ior, Ior, Xos, Xos
Xos, Xos, Ior, Uue, Uue, Ior, Ior^Edb, Ior, Uhe, Ior, Ior^Es, Ior^Es, Ior^Es, Ior, Ior, Xos, Xos
Xos, Xos, Ior, Uue, Ior, Ior^Es, Ior^Edb, Uhe, Uhe, Uhe, Ior, Ior^Es, Rd^Edt, Ior, Ior, Xos, Xos
Xos, Xos, Ior, Ior, Ior, Ior^Es, Ior^Es, Uhe, 1 Uhe, Uhe, Rd^Es, Rd^Edt, Rd^Edt, Ior, Ior, Xos, Xos
Xos, Xos, Ior, Ior, Ior, Ior^Es, Ior^Es, Ior, Urc, Ior, Ior, Ior, Ior, Ior, Ior, Xos, Xos
Xos, Xos, Cte, Cte, Cte, Rd^Edt, Ior, Urc, Urc, Urc, Ior, Ior^Edt, Urc, Urc, Urc, Xos, Xos
Xos, Xos, Cte^Emf, Kte, Cte, Cte, Uue, Ior, Rd, Rd, Uue, Rd^Edt, Ior, Urc, Ior, Xos, Xos
Xos, Xos, Xos, Xos, Xos, Xos, Xos, Xos, Xos, Xos, Xos, Xos, Xos, Xos, Xos, Xos, Xos
Xos, Xos, Xos, Xos, Xos, Xos, Xos, Xos, Xos, Xos, Xos, Xos, Xos, Xos, Xos, Xos, Xos
