Xos, Xos, Xos, Xos, Xos, Xos, Xos, Xos, Icn, Xos, Xos, Xos, Xos, Xos, Xos, Xos, Xos
Xos, Xos, Xos, Xos, Xos, Xos, Xos, Xos, 1 Icn^Pw|o, Xos, Xos, Xos, Xos, Xos, Xos, Xos, Xos
Xos, Xos, Rd, Rd, Ior^Edt, Rd^Edt, Rd, Xos^Efs, Ior, Xos^Efs, Ior, Ior, Ior, Ior, Ior, Xos, Xos
Xos, Xos, Ior, Ior, Ior, Ior, Ior, Ior, Ior, Ior, Ior, Ior, Ior, Ior, Ior, Xos, Xos
Xos, Xos, Ior, Rb, Ior, Ior, Ior^Edb, Ior, Rd^Edb, Ior, Ior, Ior, Ior, Ior, Ior, Xos, Xos
Xos, Xos, Ior, Ior, Ior, Ior, Ior^Edb, Rd^Edb, Rd^Edt, Ior, Ior, Ior, Rd^Edt, Ior, Ior, Xos, Xos
Xos, Xos, Ior, Ior, Ior, Ior, Ior, Rd, Ior, Ior, Rd, Rd^Edt, Rd^Edt, Ior, Ior, Xos, Xos
Xos, Xos, Ior, Ior, Ior, Ior, Ior, Ior, Urc, Ior, Ior, Ior, Ior, Ior, Ior, Xos, Xos
Xos, Xos, Rd, Rd^Edt, Rd^Edt, Rd^Edt, Ior, Urc, Urc, Urc, Ior, Ior^Edt, Urc, Urc, Urc, Xos, Xos
Xos, Xos, Rd, Rd, Rd, Rd^Edt, Ior, Ior, Rd, Rd, Rd, Rd^Edt, Ior, Urc, Ior, Xos, Xos
Xos, Xos, Xos, Xos, Xos, Xos, Xos, Xos, Xos, Xos, Xos, Xos, Xos, Xos, Xos, Xos, Xos
Xos, Xos, Xos, Xos, Xos, Xos, Xos, Xos, Xos, Xos, Xos, Xos, Xos, Xos, Xos, Xos, Xos
