Dd, Dd, Dd, Dd, Dd^Esd, Dd^Esd, Hd, Hd, Hd, Dd, Hd, Dd, Hd, Hd, Dd^Ftd, Dd^Ftd, Dd^Ftd, Dd, Dd, Dd, Rd
Dd, Dd, Dd, Dd, Dd, Dd, Dd, Hd, Dd, Hd, Hd, Hd, Dd^Ftd, Hd, Rd, Rd, Rd, Rd, 3 Rd, Rd, Dd
Rd, Rd, Rd, Rd, Rd, Rd, Rd, Rd, Rd, Dd, Dd^Vda, Dd^Ftd, Rd, Rd, Hd, Dd, Hd, Dd, Dd, Dd^Ftd, Dd
Hd, Dd, Hd, Dd, Hd, Dd, Hd, Dd^Dc, Rd, Dd, Dd, Dd, Rd, Dd^Ftd, Dd, Hd, Hd, Hd, Hd, Hd, Hd
Mdd, Hd, Hd, Hd, Hd, Hd, Dd, Dd, Dd, Rd, Rd, Rd, Dd, Dd, Dd^Ftd, Hd, Dd^Ftd, Hd, Mdd, Mdd, Mdd
Mdd, Mdd, Hd, Hd, Hd, Hd, Dd, Dd, Ds, Dd, Dd, Dd, Ds, Dd, Dd^Esd, Dd^Ftd, Dd^Fts, Dd^Fts, Hd, Mdd, Mdd
Hd, Hd, Dd^Edp, Dd^Esd, Dd, Dd, Dd, Dd, Ds, Ds, Re, Ds, Re, Ds, Re, Ds, Dd^Fts, Dd^Fts, Dd^Ftd, Hd, Dd
Dd, Hd, Dd, Dd, Dd^Ftd, Dd^Ftd, Dd, Ds, Re, Ds, Re, Re, Re, Re, Re, Ds, Ds, Dd^Fts, Dd^Ftd, Hd, Dd^Esd
Dd, Dd, Dd, Dd, Dd, Dd^Fts, Ds, Ds, Re, Re, Re^Es, Re, Sm, Re^Dr, Re^Es, Re, Ds, Dd, Dd^Ftd, Dd, Dd
Hd, Hd, Hd, Hd, Dd, Dd, Ds, Re, Re, Re, Re^Dr, Sm, 2 Sm^Edt, Sm^Edt, Re, Re, Re, Dd, Dd, Dd, Dd
Hd, Hd, Hd, Dd, Dd^Fts, Ds, Ds, Re, Re, Re^Es, Sm, Sm^Edt, Sm, Sm^Edt, Re^Es, Re, Ds, Ds, Dd, Dd, Dd
Dd, Hd, Dd, Dd^Ftd, Dd^Fts, Dd^Fts, Dd, Ds, Re, Re, Sm^Edt, Sm^Edt, Sm, Re^Dr, Re, Re, Ds, Ds, Hd, Hd, Dd
Dd, Dd^Edp, Dd, Dd, Dd^Ftd, Dd^Vdr, Dd, Ds, Re, Re, Re, Re^Dr, Re, Re^Es, Re, Ds, Dd, Dd^Edp, Dd, Hd, Dd
Dd, Dd, Dd, Dd, Dd, Dd, Dd^Esd, Dd, Ds, Ds, Re, Re^Es, Re, Re, Ds, Re, Dd, Dd, Dd^Ftd, Dd, Dd
Hd, Hd, Hd, Hd, Hd, Hd, Hd, Dd, Hd, Dd, Dd, Ds, Dd, Ds, Dd, Ds, Dd, Dd^Vdr, Dd, Dd, Dd
Dd, Hd, Dd, Hd, Hd, Hd, Hd, Hd, Hd, Hd, Dd, Dd^Esd, Dd^Esd, Dd^Esd, Dd, Dd, Hd, Dd, Dd, Dd, Dd^Esd
Dd, Dd, Dd, Dd, Dd, Dd, Dd, Dd, Dd, Dd, Dd, Dd, Hd, Hd, Hd, Hd, Hd, Hd, Hd, Hd, Hd
Dd, Dd, Dd, Dd, Dd, Dd, Dd^Esd, Dd, Dd, Dd, Dd, Dd, Hd, Hd, Hd, Hd, Hd, Hd, Hd, Hd, Hd
Dd, Dd, Dd^Esd, Dd, Dd, Dd, Dd, Dd, Dd, Dd^Edpp, Dd, Dd, Dd, Dd, Dd, Dd, Dd^Esd, Hd, Dd, Hd, Hd
Dd, Dd, Hd, Hd, Hd, Dd, Hd, Dd, Hd, Dd^Esd, Dd, Dd, Dd, Dd, Dd, Dd, Dd^Dc, Dd, Dd, Dd, Dd
Dd, Dd, Dd, Hd, Hd, Hd, Hd, Hd, Hd, Hd, Hd, Dd, Dd, Dd, Dd, Dd, Dd, Dd, Dd, Dd, Dd
Dd^Edpp, Dd, Dd, Dd^Esd, Dd, Dd, Dd^Edb, Dd^Vdt, Dd^Edb, Dd, Dd, Dd, Dd, Dd, Dd^Esd, Dd, Dd, Dd, Dd, Dd, Dd
Hd, Hd, Dd, Dd, Dd, Dd, Dd, Dd^Edb, Dd^Edp, Dd, Dd, Dd, Hd, Hd, Hd, Dd, Hd, Dd, Dd, Dd, Dd
Hd, Hd, Hd, Hd, Hd, Dd, Hd, Dd, Hd, Dd, Dd, Dd, Dd, Hd, Dd^Edp, Hd, Hd, Hd, Hd, Hd, Hd
Dd^Edp, Hd, Hd, Hd, Hd, Hd, Hd, Hd, Hd, Hd, Hd, 1 Dd, Dd, Dd, Dd^Esd, Hd, Dd, Hd, Hd, Hd, Hd
Dd, Dd, Dd, Dd, Dd, Hd, Dd, Hd, Dd, Hd, Dd, Dd^Esd, Dd, Dd, Dd, Dd, Dd, Dd, Dd, Dd, Dd^Esd
Dd, Dd^Dc, Dd, Dd, Dd, Dd, Dd, Dd, Dd, Dd, Dd, Dd, Dd, Dd, Dd, Dd, Dd, Dd, Dd, Dd, Dd
