Hd, Hd, Hd, Hd, Hd, Hd, Hd, Hd, Hd, Hd, Hd, Dd, Hd, Hd, Dd, Dd, Dd, Dd, Dd^Esd, Hd, Hd, Mdd, Mdd, Mdd, Mdd, Dd, Mdd, Dd, Ds, Dd, Mdd, Mdd, Mdd, Hd, Hd, Hd, Hd
Dd, Hd, Hd, Hd, Hd, Hd, Hd, Hd, Hd, Hd, Dd, Hd, Hd, Hd, Hd, Dd, Dd, Dd, Rd, Hd, Hd, Mdd, Hd, Mdd, Mdd, Mdd, Mdd, Mdd, Hd, Dd, Dd, Mdd, Ds, Dd, Dd, Hd, Hd
Dd, Dd, Dd^Esd, Hd, Hd, Hd, Hd, Hd, Hd, Dd, Dd, Dd, Dd, Dd, Dd, Dd, Rd, Rd^Esd, Cd, Rd, Rd, Hd, Hd, Hd, Hd, Hd, Ds, Ds, Dd, Dd^Edp, Ds, Dd, Ds, Ds, Mdd, Mdd, Mdd
Hd, Dd, Dd, Hd, Dd^Esd, Dd, Dd, Hd, Dd, Hd, Dd, Cd^Ebn, Cd, Dd, Dd, Dd, Rd, Cd, Cd, Cd, Rd, Dd, Dd, Dd, Cd, Cd^Ebn, Dd, Ds, Dd, Dd, Ds, Dd, Mdd, Ds, Mdd, Mdd, Mdd
Hd, Hd, Dd, Dd, Dd, Dd, Dd, Dd^Edp, Dd, Dd, Rd, Cd, Rd, Rd, Rd, Rd, Rd, Cd, Cd, Cd, Rd^Esd, Rd, Rd, Rd, Rd, Cd, Rd^Esd, Dd, Cd^Ebn, Dd, Dd, Hd, Hd, Mdd, Mdd, Mdd, Mdd
Hd, Hd, Hd, Dd, Dd^Edpp, Dd, Dd, Dd, Dd^Ftd, Rd^Esd, Dd^Vda, Rd, Dd, Cd^Ftd, Dd^Edt, Cd^Ftd, Hd, Rd, Rd, Rd, Dd, Cd^Ftd, Rd, Dd^Vda, Ds, Rd, Rd, Cd, Cd, Dd, Dd, Hd, Ds, Ds, Hd, Mdd, Hd
Hd, Hd, Hd, Dd, Dd, Cd^Ebn, Cd, Rd, Rd^Esd, Rd, Dd, Rd, Dd, Hd, Dd^Edt, Dd, Hd, Dd, Rd, Ds^Edt, Hd, Dd, Dd, Rd^Esd, Cd^Ftd, Dd, Rd, Rd, Rd, Rd, Cd, Dd, Dd, Ds, Hd, Hd, Hd
Dd, Hd, Hd, Dd, Dd, Cd, Cd, Rd, Dd, Dd, Ds^Es, Rd^Esd, Rd, Dd, Hd, Hd, Gd, Dd^Vda, 3 Rd, Dd, Dd, Hd, Dd, Rd, Rd^Esd, Ds, Dd, Dd^Edt, Ds^Edt, Rd, Dd^Vda, Cd, Cd, Dd, Dd, Hd, Dd
Dd, Dd, Hd, Hd, Dd, Rd, Rd, Rd, Dd^Edt, Hd, Hd, Cd^Ftd, Dd, Rd, Hd, Dd, Rd, Rd, Rd, Rd, Rd, Hd, Hd, Dd, Rd, Dd^Vda, Rd, Rd, Rd, Rd, Rd, Rd, Rd, Dd, Dd, Dd, Dd
Dd^Edp, Dd, Dd^Ftd, Dd^Ftd, Dd^Ftd, Rd, Dd^Es, Dd, Hd, Hd, Hd, Dd, Rd, Rd^Esd, Hd, Gd, Gs^Ft, Cdr^Ebn, Rd, Cdr^Ebn, Gs^Ft, Gd, Hd, Ds, Rd, Rd, Cd, Cd, Cd, Cd, Cd, Rd^Esd, Rd, Rd, Cd, Dd, Dd
Dd, Dd, Rd, Rd, Rd, Rd^Esd, Ds, Dd^Edt, Dd^Es, Ds, Cd^Ftd, Dd, Rd, Dd^Vda, Dd, Gd, Gs^Ft, Gs^Ft, Wwt, Gs^Ft, Gs^Ft, Gd, Dd, Dd^Vda, Rd, Kd, Gs^Ft, Gs^Ft, Cd, Gs^Ft, Gs^Ft, Kd, Rd, Rd, Cd, Dd, Dd
Dd^Edp, Rd, Cd, Kd, Cd, Rd, Rd, Rd, Rd, Rd, Rd, Rd, Rd, Rd^Esd, Rd, Rd, Rd, Wwt, Wwt, Wwt, Rd, Rd, Rd^Esd, Rd, Rd, Cd, Cd, Kd, 2 Kd, Kd, Cd, Cd, Rd, Rd^Vda, Cd, Dd, Dd^Edp
Rd, Rd, Cd, 1 Kd, Cd, Rd, Dd^Edp, Dd, Dd, Rd, Dd^Vda, Dd^Edt, Ds, Dd, Hd, Dd, Rd, Rd, Rd, Rd, Rd^Esd, Dd^Vda, Dd, Ds, Rd^Esd, Cd, Gs^Ft, Kd, Rd, Kd, Gs^Ft, Cd, Rd, Rd, Cd, Dd, Dd
Dd, Rd, Cd, Cd, Cd, Rd, Dd, Dd, Rd, Rd, Rd, Dd, Hd, Dd^Edt, Hd, Dd, Rd^Esd, Cdr^Ebn, Rd, Cdr^Ebn, Rd, Dd^Ft, Hd, Dd^Es, Rd, Kd, Cd, Gs^Ft, Rd, Gs^Ft, Cd, Kd, Rd, Rd^Esd, Cd, Dd, Dd
Dd^Edpp, Rd^Esd, Rd, Cd, Rd, Rd, Dd, Cd, Cd, Rd, Rd, Dd, Hd, Dd, Dd^Edt, Hd, Dd, Rd, Rd, Rd, Dd, Dd, Ds, Dd, Ds, Rd, Rd, Cd, Rd, Cd, Rd, Rd, Rd, Dd^Esd, Dd, Dd, Dd^Esd
Dd, Dd, Dd^Ftd, Rd, Dd^Ftd, Dd, Dd, Cd^Ebn, Dd, Rd^Esd, Rd, Cd^Ftd, Dd, Hd, Ds^Edt, Hd, Dd, Dd, Rd, Dd, Hd, Dd, Rd, Dd, Rd, Dd^Vda, Rd, Rd, Rd, Rd^Esd, Rd, Dd^Vda, Dd, Dd, Hd, Dd, Dd
Dd^Edpp, Dd, Dd, Dd^Ftd, Dd, Dd, Dd, Dd, Dd, Rd, Rd, Rd, Rd, Hd, Ds, Hd, Hd, Dd^Vda, Rd, Dd, Dd, Rd, Dd^Vda, Rd, Cd^Ftd, Rd, Cd, Rd^Esd, Rd, Rd, Cd, Dd, Dd, Dd, Hd, Dd, Dd
Hd, Dd, Dd, Dd, Dd, Dd, Hd, Dd, Dd, Dd, Rd, Rd^Vda, Rd, Dd^Edt, Cd^Ftd, Ds, Ds, Dd^Edt, Rd, Ds, Rd, Rd^Esd, Dd, Dd, Dd, Dd, Dd, Cd, Rd, Cd, Dd^Esd, Dd, Dd, Hd, Hd, Hd, Hd
Hd, Hd, Dd, Dd^Esd, Dd, Dd^Edp, Hd, Dd, Dd, Cd, Cd, Rd, Rd, Rd, Rd, Rd, Rd, Rd, Cd, Rd, Rd, Cd^Ftd, Hd, Dd, Hd, Dd^Esd, Dd^Edpp, Dd, Rd, Dd, Dd, Dd, Hd, Dd, Hd, Hd, Hd
Hd, Hd, Hd, Dd^Esd, Dd, Hd, Hd, Hd, Hd, Cd^Ebn, Dd, Rd, Rd, Rd, Rd, Rd, Rd, Cd, Cd, Cd, Rd^Esd, Dd, Dd, Hd, Hd, Dd, Dd, Dd, Rd, Dd, Dd, Hd, Hd, Hd, Hd, Hd, Hd
Dd, Hd, Hd, Hd, Hd, Dd, Dd^Edpp, Hd, Hd, Hd, Hd, Dd^Esd, Dd^Esd, Cd, Cd, Rd, Rd, Cd, Cd, Cd, Rd, Dd, Dd, Hd, Hd, Dd, Hd, Hd, Dd, Rd, Dd, Dd^Edpp, Hd, Hd, Hd, Hd, Hd
Dd, Dd, Hd, Hd, Hd, Dd, Dd, Dd, Hd, Hd, Hd, Dd, Dd^Dc, Cd^Ebn, Dd^Edpp, Dd^Dc, Dd, Rd, Rd^Esd, Rd, Dd, Dd, Hd, Hd, Hd, Hd, Hd, Hd, Dd, Rd^Esd, Dd, Dd, Dd, Hd, Hd, Hd, Hd
Dd, Dd, Dd^Esd, Dd, Hd, Hd, Dd, Dd, Dd, Hd, Hd, Hd, Dd^Dc, Dd, Dd, Dd, Dd, Dd^Esd, Dd, Dd, Dd, Hd, Hd, Hd, Hd, Hd, Dd, Hd, Dd, Rd, Dd, Dd, Hd, Hd, Hd, Hd, Hd
