Dd, Dd, Dd^Edb, Dd, Dd, Dd, Hd, Hd, Hd, Dd, Qxua^Es, Qxua^Es, Qxua^Es, Qxua^Es, Hd, Hd, Hd, Dd, Dd, Dd, Dd, Dd, Dd, Qxua^Es, Qxua^Es, Dd^Edb, Dd, Dd^Esd, Dd, Dd, Dd, Dd, Dd
Qxua^Es, Dd, Dd, Dd, Dd, Hd, Hd, Hd, Hd, Dd, Dd^Vdt, Qxua^Es, Qxua^Es, Dd, Dd, Hd, Hd, Hd, Mdd, Dd^Dc, Dd, Dd, Dd, Qxua^Es, Qxua^Es, Qxua^Es, Dd, Dd, Dd, Dd, Dd, Dd, Dd
Qxua^Es, Dd, Dd, Dd, Cud, Cud, Cud, Qxua^Es, Qxua^Es, Hd, Qxua^Es, Qxua^Es, Qxua^Es, Dd, Dd, Dd, Hd, Mdd, Hd, Mdd, Hd, Dd^Edb, Dd, Dd, Qxua^Es, Qxua^Es, Cud, Cud, Cud, Dd^Edp, Qxua^Es, Dd, Dd
Qxua^Es, Qxua^Es, Qxua^Es, Qxua^Es, Cud, 3 Cud^Kov, Cud, Rb, Hd, Qxua^Es, Hd, Qxua^Es, Dd, Qxua^Es, Cdr, Dd, Dd, Hd, Hd, Hd, Hd, Dd^Vdt, Dd, Dd^Esd, Rd, Rb, Cud, 4 Cud^Kov, Cud, Qxua^Esd, Qxua^Es, Dd^Edp, Dd
Hd, Qxua^Es, Qxua^Es, Qxua^Es, Dd^Edp, Cud, Rb, Rb, Rd, Dd^Edb, Rd, Dd, Rd, Rd, Rd^Edt, Rd^Edb, Ds^Esd, Mdd, Dd, Dd^Ftd, Dd^Edpp, Hd, Dd, Dd, Rd, Rb, Rb, Cud, Qxua^Es, Qxua^Es, Qxua^Es, Qxua^Es, Qxua^Es
Hd, Hd, Qxua^Es, Dd, Dd, Dd^Edb, Dd, Rd, Rd, Rd, Dd^Vdr, Dd, Dd, Ds^Esd, Ds^Edt, Ds^Edt, Ds^Esd, Ds^Esd, Cdr^Dr, Dd, Dd, Dd^Dc, Cdr, Cdr, Rd, Rd, Dd^Vdr, Dd, Dd, Dd^Edb, Dd, Qxua^Es, Qxua^Es
Hd, Qxua^Es, Mdd, Mdd, Mdd, Hd, Hd, Rd, Dd^Edb, Rd, Rd, Rd, Hd, Dd^Edb, Hd, Dd, Dd, Dd^Esd, Dd^Es, Rd^Esd, Rd^Edt, Dd, Rd, Cdr, Dd^Ftd, Hd, Hd, Hd, Hd, Hd, Qxua^Es, Qxua^Es, Dd
Dd^Esd, Qxua^Es, Qxua^Es, Mdd, Hd, Hd, Hd, Dd, Dd, Dd, Rd, Rd, Dd, Hd, Mdd, Hd, Kdr, Hd, Hd, Ds, Rd^Edt, Dd^Edt, Rd, Dd, Kdr, Dd^Ftd, Dd^Esd, Hd, Hd, Hd, Hd, Hd, Dd
Dd, Dd, Dd, Dd^Vdt, Hd, Hd, Hd, Cdr, Rd, Rd, Dd^Edt, Rd^Edt, Cdr^Dr, Dd, Hd, Hd, Cdr, Cdr, Hd, Dd^Vdr, Dd, Rd, Rd, Dd, Rd, Dd^Edpp, Dd, Hd, Hd, Hd, Hd, Hd, Hd
Dd, Dd, Dd, Dd, Dd, Dd, Dd, Dd, Rd, Dd, Dd^Edb, Rd^Esd, Rd^Esd, Ds^Edb, Dd^Vdr, Hd, Dd^Es, Hd^Es, Hd, Hd, Hd, Dd, Dd, Dd, Rd, Rd, Rd, Dd, Dd^Vdt, Hd, Dd^Edb, Hd, Hd
Dd, Dd, Dd, Dd, Dd, Dd, Dd^Edp, Dd^Do, Cdr, Dd, Dd, Dd^Vdr, Rd^Edb, Ds, Ds^Edt, Ds, Ds, Dd^Es, Dd^Edt, Dd^Edt, Dd^Es, Cdr^Dr, Dd^Dr, Rd, Dd, Dd, Dd, Dd, Dd, Dd, Dd, Dd, Dd
Dd, Dd, Dd^Esd, Dd^Esd, Hd, Dd, Hd, Dd, Cdr, Cdr^Dr, Hd, Dd, Dd, Rd, Dd^Edt, Ds^Edt, Rd, Rd^Esd, Rd, Rd^Edt, Dd, Dd^Esd, Dd^Edpp, Rd, Dd, Dd^Vdr, Dd, Dd, Dd^Edb, Dd, Dd, Dd, Dd
Dd, Dd, Dd, Dd^Edb, Dd, Hd, Hd, Hd, Hd, Hd, Hd, Hd, Hd, Hd, Dd, Dd, Dd, Dd, Dd, Dd, Hd, Cdr, Cdr, Dd, Hd, Dd, Hd, Dd, Hd, Dd^Edb, Dd, Dd, Dd
Dd, Dd, Dd^Edb, Dd, Dd, Dd, Dd^Edb, Dd^Vdt, Dd, Hd, Dd, Hd, Hd, Hd, Hd, Dd, Rd, Dd, Dd, Hd, Hd, Hd, Hd, Hd, Hd, Hd, Hd, Hd, Hd, Hd, Hd, Dd, Dd
Dd, Dd, Dd, Dd, Dd, Dd, Dd^Esd, Dd, Dd, Dd, Dd, Dd, Dd^Vda, Dd, Dd, Dd, Rd, Dd, Dd, Dd^Ftd, Dd^Ftd, Hd, Dd^Ftd, Hd, Hd, Hd, Hd, Hd, Hd, Hd, Hd, Hd, Hd
Dd, Dd, Dd, Dd, Dd, Dd, Dd, Dd, Dd, Dd, Dd, Dd, Dd, Dd, Ce, Dd, Cd^Ecf, Rd, Cdr, Dd, Dd^Ftd, Dd^Ftd, Dd, Dd, Dd^Edb, Dd, Dd, Hd, Hd, Hd, Hd, Hd, Hd
Dd, Dd, Dd, Hd, Hd, Dd, Hd, Dd, Hd, Dd, Dd, Dd, Dd^Dc, Ce, 1 Ke, Ce, Cdr, Cdr, 2 Kdr, Cdr, Dd, Dd^Edb, Dd^Edb, Dd, Dd, Dd, Dd, Dd^Vdt, Dd, Dd, Dd, Hd, Dd
Dd^Edp, Dd, Dd, Hd, Hd, Hd, Hd, Hd, Hd, Hd, Dd, Dd, Dd, Ce, Ce, Ce, Rd, Cdr, Cdr, Cdr, Dd, Dd^Vda, Dd, Dd, Dd, Dd^Dc, Dd, Dd, Dd, Dd, Dd^Edb, Dd, Dd
Dd, Dd, Dd^Esd, Dd, Dd, Hd, Hd, Hd, Hd, Hd, Hd, Dd, Dd^Edb, Rd, Rd, Rd, Rd, Rd, Rd, Rd, Dd, Hd, Hd, Dd^Esd, Hd, Dd, Dd^Edb, Dd, Dd, Dd, Dd, Dd^Edb, Dd
Dd, Dd^Dc, Dd, Dd, Hd, Dd, Hd, Hd, Hd, Hd, Hd, Hd, Dd, Dd, Dd, Rd, Rd, Rd, Dd, Dd, Dd, Dd, Hd, Hd, Hd, Hd, Hd, Hd, Hd, Dd, Dd, Dd, Dd
Dd, Dd, Dd, Hd, Hd, Hd, Hd, Hd, Hd, Hd, Hd, Hd, Dd, Dd, Dd, Rd, Rd, Rd, Dd, Dd, Dd, Dd, Dd, Hd, Hd, Hd, Hd, Hd, Hd, Hd, Dd, Dd, Dd
