Dd, Dd, Dd^Edb, Dd, Dd, Dd, Hd, Hd, Hd, Dd, Dd, Dd, Dd, Dd, Hd, Hd, Hd, Dd, Dd, Dd, Dd, Dd, Dd, Dd, Dd, Dd^Edb, Dd, Dd^Esd, Dd, Dd, Dd, Dd, Dd
Dd^Esd, Dd, Dd, Dd, Dd, Hd, Hd, Hd, Hd, Dd, Dd^Vdt, Dd, Dd, Dd, Dd, Hd, Hd, Hd, Mdd, Dd^Dc, Dd, Dd, Dd, Dd, Dd^Edb, Dd, Dd, Dd, Dd, Dd, Dd, Dd, Dd
Dd, Dd, Dd, Dd, Cud, Cud, Cud, Hd, Hd, Hd, Hd, Dd, Dd, Dd, Dd, Dd, Hd, Mdd, Hd, Mdd, Hd, Dd^Edb, Dd, Dd, Dd, Dd, Cud, Cud, Cud, Dd^Edp, Dd, Dd, Dd
Hd, Dd, Dd, Dd, Cud, 3 Kud, Cud, Rb, Hd, Hd, Hd, Dd^Edb, Dd, Dd, Cdr, Dd, Dd, Hd, Hd, Hd, Hd, Dd^Vdt, Dd, Dd^Esd, Dd, Rb, Cud, 4 Kud, Cud, Dd, Dd, Dd^Edp, Dd
Hd, Hd, Hd, Dd, Dd^Edp, Cud, Rb, Rb, Rd, Dd^Edb, Dd, Dd, Rd, Rd, Rd^Edt, Rd^Edb, Ds^Esd, Mdd, Dd, Dd^Ftd, Dd^Edpp, Hd, Dd, Dd, Rd, Rb, Rb, Cud, Dd, Dd, Dd, Dd, Dd^Edb
Hd, Hd, Hd, Dd, Dd, Dd^Edb, Dd, Dd, Rd, Dd, Dd^Vdr, Dd, Dd, Ds^Esd, Ds^Edt, Ds^Edt, Ds^Esd, Ds^Esd, Cdr^Dr, Dd, Dd, Dd^Dc, Cdr, Cdr, Dd, Dd, Dd^Vdr, Dd, Dd, Dd^Edb, Dd, Dd, Dd^Esd
Hd, Hd, Mdd, Mdd, Mdd, Hd, Hd, Dd, Dd^Edb, Dd, Dd, Dd, Hd, Dd^Edb, Hd, Dd, Dd, Dd^Esd, Dd^Es, Rd^Esd, Rd^Edt, Dd, Dd, Cdr, Dd^Ftd, Hd, Hd, Hd, Hd, Hd, Hd, Dd, Dd
Dd^Esd, Hd, Hd, Mdd, Hd, Hd, Hd, Dd, Dd, Dd, Rd, Dd, Dd, Hd, Mdd, Hd, Kdr, Hd, Hd, Ds, Rd^Edt, Dd^Edt, Dd, Dd, Kdr, Dd^Ftd, Dd^Esd, Hd, Hd, Hd, Hd, Hd, Dd
Dd, Dd, Dd, Dd^Vdt, Hd, Hd, Hd, Cdr, Dd, Dd, Dd^Edt, Rd^Edt, Cdr^Dr, Dd, Hd, Hd, Cdr, Cdr, Hd, Dd^Vdr, Dd, Rd, Dd, Dd, Dd, Dd^Edpp, Dd, Hd, Hd, Hd, Hd, Hd, Hd
Dd, Dd, Dd, Dd, Dd, Dd, Dd, Dd, Dd, Dd, Dd^Edb, Rd^Esd, Rd^Esd, Ds^Edb, Dd^Vdr, Hd, Dd^Es, Hd^Es, Hd, Hd, Hd, Dd, Dd, Dd, Dd, Dd, Dd, Dd, Dd^Vdt, Hd, Dd^Edb, Hd, Hd
Dd, Dd, Dd, Dd, Dd, Dd, Dd^Edp, Dd^Do, Cdr, Dd, Dd, Dd^Vdr, Rd^Edb, Ds, Ds^Edt, Ds, Ds, Dd^Es, Dd^Edt, Dd^Edt, Dd^Es, Cdr^Dr, Dd^Dr, Dd, Dd, Dd, Dd, Dd, Dd, Dd, Dd, Dd, Dd
Dd, Dd, Dd^Esd, Dd^Esd, Hd, Dd, Hd, Dd, Cdr, Cdr^Dr, Hd, Dd, Dd, Rd, Dd^Edt, Ds^Edt, Rd, Rd^Esd, Rd, Rd^Edt, Dd, Dd^Esd, Dd^Edpp, Dd, Dd, Dd^Vdr, Dd, Dd, Dd^Edb, Dd, Dd, Dd, Dd
Dd, Dd, Dd, Dd^Edb, Dd, Hd, Hd, Hd, Hd, Hd, Hd, Hd, Hd, Hd, Dd, Dd, Dd, Dd, Dd, Dd, Hd, Cdr, Cdr, Dd, Hd, Dd, Hd, Dd, Hd, Dd^Edb, Dd, Dd, Dd
Dd, Dd, Dd^Edb, Dd, Dd, Dd, Dd^Edb, Dd^Vdt, Dd, Hd, Dd, Hd, Hd, Hd, Hd, Dd, Rd, Dd, Dd, Hd, Hd, Hd, Hd, Hd, Hd, Hd, Hd, Hd, Hd, Hd, Hd, Dd, Dd
Dd, Dd, Dd, Dd, Dd, Dd, Dd^Esd, Dd, Dd, Dd, Dd, Dd, Dd^Vda, Dd, Dd, Dd, Rd, Dd, Dd, Dd^Ftd, Dd^Ftd, Hd, Dd^Ftd, Hd, Hd, Hd, Hd, Hd, Hd, Hd, Hd, Hd, Hd
Dd, Dd, Dd, Dd, Dd, Dd, Dd, Dd, Dd, Dd, Dd, Dd, Dd, Dd, Ce, Dd, Cd^Ecf, Rd, Cdr, Dd, Dd^Ftd, Dd^Ftd, Dd, Dd, Dd^Edb, Dd, Dd, Hd, Hd, Hd, Hd, Hd, Hd
Dd, Dd, Dd, Hd, Hd, Dd, Hd, Dd, Hd, Dd, Dd, Dd, Dd^Dc, Ce, 1 Ke, Ce, Cdr, Cdr, 2 Kdr, Cdr, Dd, Dd^Edb, Dd^Edb, Dd, Dd, Dd, Dd, Dd^Vdt, Dd, Dd, Dd, Hd, Dd
Dd^Edp, Dd, Dd, Hd, Hd, Hd, Hd, Hd, Hd, Hd, Dd, Dd, Dd, Ce, Ce, Ce, Rd, Cdr, Cdr, Cdr, Dd, Dd^Vda, Dd, Dd, Dd, Dd^Dc, Dd, Dd, Dd, Dd, Dd^Edb, Dd, Dd
Dd, Dd, Dd^Esd, Dd, Dd, Hd, Hd, Hd, Hd, Hd, Hd, Dd, Dd^Edb, Rd, Rd, Rd, Rd, Rd, Rd, Rd, Dd, Hd, Hd, Dd^Esd, Hd, Dd, Dd^Edb, Dd, Dd, Dd, Dd, Dd^Edb, Dd
Dd, Dd^Dc, Dd, Dd, Hd, Dd, Hd, Hd, Hd, Hd, Hd, Hd, Dd, Dd, Dd, Rd, Rd, Rd, Dd, Dd, Dd, Dd, Hd, Hd, Hd, Hd, Hd, Hd, Hd, Dd, Dd, Dd, Dd
Dd, Dd, Dd, Hd, Hd, Hd, Hd, Hd, Hd, Hd, Hd, Hd, Dd, Dd, Dd, Rd, Rd, Rd, Dd, Dd, Dd, Dd, Dd, Hd, Hd, Hd, Hd, Hd, Hd, Hd, Dd, Dd, Dd
