Hd, Hd, Hd, Hd, Hd, Hd, Hd, Dd, Dd, Dd, Ds, Hd, Mdd, Mdd, Mdd, Mdd, Mdd, Mdd, Hd, Dd, Hd, Hd, Hd, Hd, Hd, Mdd, Mdd, Mdd^Xm, Mdd^Xm, Mdd^Xm, Mdd, Mdd, Mdd, Dd, Dd, Rd, Dd, Dd^Fts, Dd^Fts, Mdd, Mdd, Mdd, Mdd
Hd, Hd, Hd, Hd, Hd, Hd, Hd, Dd, Dd, Dd, Ds, Ds, Mdd, Mdd, Hd, Mdd, Hd, Mdd, Hd, Hd, Hd, Hd, Hd, Hd, Mdd, Mdd, Mdd, Mdd^Xm, Mdd^Xm, Mdd, Mdd, Mdd, Hhd, Hhd, Dd, Rd, Gd^Fts, Gd^Fts, Mdd, Mdd, Mdd, Mdd, Mdd
Hd, Hd, Hd, Hd, Dd, Hd, Dd, Dd, Dd, Ds, Hd, Mdd, Mdd, Mdd, Hd, Hd, Dd, Hd, Dd, Hd, Hd, Hd, Hd, Hd, Hd, Mdd, Mdd^Xm, Mdd^Xm, Mdd, Mdd, Hhd, Mdd, Hhd, Dd^Vda, Rd, Rd, Gs^Fts, Gs^Fts, Wot, Wot, Mdd, Mdd, Ds
Hd, Hd, Hd, Hd, Hd, Dd, Dd^Edb, Dd, Dd, Hd, Hd, Hd, Hd, Hd, Hd, Dd, Dd^Vdt, Ds, Hd, Mdd, Mdd, Mdd, Mdd, Mdd, Mdd, Mdd, Mdd^Xm, Mdd^Xm, Mdd, Hhd, Hhd, Hhd, Hhd, Dd, Rd, Gd, Gs^Ftd, Wwt, Wot, Wot, Gs^Ftd, Gd, Gd
Hd, Hd, Hd, Hd, Hd, Dd, Dd^Vdt, Hd, Mdd, Hd, Mdd, Mdd, Ds, Ds, Dd, Dd^Edb, Dd^Edb, Dd, Mdd, Mdd, Hd, Mdd, Mdd, Mdd, Mdd, Mdd, Mdd^Xm, Mdd, Ds^Es, Dd^Es, Ds^Es, Dd, Cd, 3 Kd, Cd, Gd, Wwt, Wwt, Wwt, Gs^Ftd, Gs^Ftd, Gd^Es, Gd
Hd, Hd, Hd, Hd, Hd, Dd^Edb, Dd^Edb, Hd, Hd, Mdd, Mdd, Hd, Hd, Ds, Dd, Dd, Hd, Hd, Hd, Mdd, Hd, Hd, Ds, Ds, Mdd, Mdd, Mdd, Mdd, Mdd, Ds^Es, Dd, Kd, Cd, Cd, Cd, Kd, Dd, Wwt, Gs^Fts, Gs^Ftd, Gd, Gd, Gd
Hd, Dd, Dd, Dd, Dd, Dd, Dd, Hd, Hd, Mdd, Hd, Hd, Dd, Dd, Dd, Dd, Dd, Dd, Dd, Hd, Hd, Dd^Dc, Ds, Ds, Mdd, Mdd, Mdd, Mdd, Hhd, Hhd, Hhd, Rd, Rd, Kd, Rd, Rd, Rd, Dd^Vda, Gd^Fts, Gd^Fts, Hhd, Mdd, Mdd
Hd, Hd, Dd, Dd, Dd, Dd, Dd, Hd, Ds, Hd, Dd, Hd, Dd, Dd, Ds, Dd, Hd, Dd^Edpp, Dd, Hd, Dd, Dd, Hd, Mdd, Hd, Mdd, Mdd, Mdd, Hhd, Hhd, Dd, Cd, Rd, Rd, Rd, Cd, Dd, Dd, Dd, Hhd^Ftd, Mdd, Mdd, Mdd^Xm
Hd, Dd, Dd, Dd, Hd, Dd, Dd, Dd, Ds, Ds, Dd, Dd^Edp, Dd, Dd, Ds, Hd, Hd, Dd, Dd, Dd^Edb, Dd^Vdt, Dd, Hd, Hd, Hd, Mdd, Mdd, Mdd, Hhd, Dd^Ftd, Dd^Vda, Dd, Rd, Rd, Dd, Dd, Dd, Dd^Fts, Dd^Fts, Hhd, Mdd, Mdd, Mdd^Xm
Dd, Dd^Edp, Dd, Hd, Hd, Dd, Dd, Dd, Hd, Dd, Dd, Dd^Vdt, Dd^Edb, Ds, Hd, Mdd, Hd, Dd, Hd, Dd^Esd, Rd^Edb, Dd^Edb, Dd, Hd, Mdd, Mdd, Hhd, Hhd, Hhd, Dd^Ftd, Dd^Ftd, Rd, Rd, Dd, Hhd, Hhd, Hhd^Ftd, Dd^Fts, Ds, Hhd, Mdd, Mdd, Mdd
Dd, Dd, Hd, Hd, Dd, Dd, Dd, Dd, Hd, Dd, Dd, Dd^Edb, Dd, Hd, Hd, Mdd, Mdd, Hd, Dd, Dd, Rd^Edb, Rd^Edb, Rd, Rd^Es, Rd^Es, Mdd, Rd^Es, Dd, Hhd, Hhd, Dd, Rd, Dd, Dd^Fts, Hhd^Ftd, Mdd, Mdd, Ds^Ftd, Dd, Hhd, Mdd, Mdd, Mdd
Dd, Hd, Hd, Hd, Dd, Dd, Hd, Hd, Hd, Dd, Dd, Dd, Ds, Ds, Mdd, Mdd, Hd, Hd, Ds^Edb, Rd^Es, Rd, Dd, Hd, Rd^Es, Mdd, Rd^Es, Dd, Rd, Rd, Dd, Rd, Rd, Dd^Fts, Dd^Fts, Mdd, Mdd, Dd^Es, Dd^Vdt, Dd, Mdd, Mdd, Mdd, Dd
Dd, Hd, Hd, Dd, Dd^Vo, Dd, Hd, Hd, Hd, Dd, Dd, Dd, Ds, Hd, Mdd, Mdd, Hd, Ds^Edb, Ds^Edb, Rd^Es, Dd^Edp, Dd, Hd, Mdd, Mdd, Hhd, Hhd, Hhd, Hhd, Dd, Dd, Rd, Dd^Fts, Dd^Fts, Hhd^Ftd, Hhd, Dd^Fts, Ds^Es, Mdd, Mdd, Mdd, Dd, Dd
Dd, Dd, Dd, Dd^Esd, Co^Qov, Co^Qov, Co^Qov, Hd, Hd, Hd, Dd, Dd^Edp, Dd, Hd, Dd, Hd, Dd, Rd, Dd, Hd, Hd, Hd, Hhd, Mdd, Mdd, Mdd, Hhd, Hhd, Dd, Dd^Vda, Rd, Rd, Dd, Dd, Dd^Fts, Dd^Fts, Hhd, Hhd, Mdd, Mdd, Dd^Es, Dd, Ds
Rd, Dd, Rd, Dd, Co^Qov, 4 Ko, Co, Co, Cer, Dd, Dd^Vo, Dd, Rd, Rd, Cdr^Edb, Rd, Rd^Es, Rd^Es, Dd, Dd, Hd, Hd, Mdd, Mdd, Hhd, Mdd, Hhd, Dd^Ftd, Dd, Dd, Rd, Rd, Dd, Dd, Hhd^Ftd, Dd^Fts, Hhd, Mdd, Mdd, Dd^Es, Dd, Dd^Es, Mdd
Dd, Rd, Dd, Rd^Ecf, Rd, Co, Cer, Cer, Rd^Edb, Rd^Edb, Rd^Edb, Rd^Edb, Dd^Edp, Rd^Edb, Rd^Edb, Rd, Dd^Edb, Dd^Vdr, Dd^Edb, Hd, Hd, Hhd, Mdd, Mdd, Hhd, Hhd, Dd, Dd, Cdr, Dd, Rd, Dd, Dd^Fts, Dd^Fts, Dd^Fts, Hhd, Mdd, Mdd, Ds^Es, Ds, Hhd, Mdd, Mdd
Dd, Dd, Dd, Dd^Vo, Rd^Edb, Cer, Rd^Edb, Rd, Rd, Dd^Edb, Dd, Dd, Hd, Hd, Hd, Dd, Dd, Dd^Edb, Rd, Dd, Hd, Mdd, Hd, Hhd, Hd, Hhd, Dd, Ds, Ds, Rd, Rd, Dd, Dd, Dd^Fts, Dd^Fts, Hhd, Dd, Ds, Ds, Hhd, Mdd, Mdd, Mdd
Dd, Dd, Dd^Esd, Dd^Edb, Dd, Rd, Dd^Edb, Dd^Edb, Dd, Rd, Rd, Dd, Rd, Hd, Rd, Dd, Dd, Dd, Mdd, Rd, Dd, Hd, Dd, Hd, Ds, Dd, Dd, Ds, Dd, Rd, Dd, Cdr, Ds, Dd, Dd^Fts, Dd, Dd, Rd, Hhd, Hhd, Mdd, Mdd, Mdd
Dd, Dd, Dd^Vo, Dd, Dd, Dd, Hd, Hd, Rd, Rd, Hd, Rd, Dd, Rd, Rd, Dd, Ds^Es, Mdd, Mdd, Hd, Dd, Dd, Dd^Dc, Ds, Ds, Dd, Dd^Vda, Dd, Rd, Rd, Dd, Dd^Dc, Ds, Rd, Rd, Dd^Vda, Hd, Dd, Hd, Mdd, Hd, Hd, Mdd
Dd, Dd, Dd, Dd^Edb, Hd, Hd, Hd, Dd, Rd, Dd^Edb, Dd^Vo, Hd, Hd, Dd, Dd, Dd, Mdd, Mdd, Hd, Hd, Dd, Ds, Dd, Dd, Dd, Dd, Dd, Rd, Dd, Dd, Dd, Ds, Dd, Ds, Rd, Dd, Ds^Esd, Hd, Hd, Hd, Hd, Mdd, Mdd
Dd, Dd, Dd, Dd, Hd, Hd, Hd, Dd, Dd, Rd^Edb, Rd, Hd, Hd, Rd, Dd, Dd, Mdd, Dd, Dd, Dd, Dd, Dd, Dd, Dd, Rd, Dd, Rd, Rd, Dd, Dd, Dd^Edpp, Dd, Dd^Ftd, Dd, Dd, Ds^Esd, Ds, Hd, Dd, Hd, Hd, Hd, Hd
Hd, Hd, Hd, Hd, Hd, Dd, Dd, Dd^Do, Dd, Dd, Rd, Dd, Dd, Rd, Dd, Mdd, Hd, Hd, Dd, Dd, Dd, Dd, Ce, Ce, Ce, Rd, Rd, Dd, Dd^Edpp, Dd^Ftd, Ds^Edpp, Ds^Edpp, Ds^Edpp, Dd, Dd, Dd, Rd, Dd, Dd, Dd, Hd, Hd, Hd
Hd, Hd, Hd, Dd, Dd, Dd, Ds^Edb, Dd, Ds^Esd, Rd, Dd, Dd, Dd, Dd, Hd, Mdd, Dd, Dd, Dd, Dd, Dd, Dd, Ce, Ce, 1 Kdr, Cd, Rd, Dd, Dd, Dd^Edpp, Dd^Ftd, Dd^Do, Dd^Ftd, Dd^Ftd, Dd, Dd^Dc, Ds, Ds^Esd, Ds^Esd, Ds^Esd, Dd, Hd, Hd
Dd, Dd, Dd, Ds^Esd, Dd, Ds^Edb, Dd, Ds^Esd, Ds^Esd, Dd, Dd, Hd, Hd, Rd, Rd, Dd, Rd, Rd, Rd, Rd, Rd, Rd, Rd, Ce, Cd, Cd, Rd, Dd, Dd, Dd^Ftd, Dd, Ds, Dd^Vda, Dd^Edpp, Dd^Edpp, Dd, Dd, Dd, Dd, Ds^Esd, Rd, Hd, Ds
Dd, Ds^Esd, Dd, Ds, Ds^Edb, Ds^Edb, Ds^Edb, Ds, Dd, Dd, Hd, Hd, Hd, Hd, Dd, Rd, Dd, Rd, Dd, Dd, Hd, Dd, Dd, Rd, Rd, Rd, Dd, Rd, Rd, Dd, Dd^Vda, Dd, Dd, Dd, Dd^Vda, Dd, Dd, Dd, Dd, Dd, Dd, Dd, Ds
Dd, Ds^Esd, Ds^Edb, Ds, Ds, Ds^Edb, Ds, Ds, Ds^Edb, Dd, Hd, Hd, Dd, Dd, Dd, Dd, Dd, Dd^Esd, Dd, Dd^Edp, Hd, Hd, Dd, Dd, Dd, Dd, Dd, Dd, Dd^Edp, Rd, Rd, Rd, Rd, Rd, Rd, Rd, Rd, Dd, Dd, Dd, Dd^Edpp, Ds^Esd, Ds
Dd, Dd, Ds^Esd, Ds^Edb, Dd, Dd, Ds^Esd, Ds^Edb, Dd, Ds^Esd, Hd, Hd, Dd, Dd, Dd^Edb, Dd^Vdr, Dd^Edb, Dd, Hd, Hd, Hd, Hd, Hd, Dd, Dd, Dd, Dd, Dd, Dd^Edp, Dd, Rd, Cd, Kd, Cdr, Cdr, Kd, Rd, Dd, Hd, Dd, Hd, Dd, Dd
Dd, Dd, Dd, Dd^Edb, Ds, Dd, Ds^Esd, Dd, Hd, Hd, Hd, Dd, Dd, Dd, Dd, Dd^Edb, Dd, Dd, Hd, Hd, Dd^Dc, Dd, Dd^Vdr, Dd, Dd, Dd, Dd, Dd, Dd^Vda, Dd^Esd, Dd, Rd, Cd, Cd, Cd, Rd, Dd^Vda, Dd, Hd, Hd, Hd, Dd^Esd, Dd
Dd, Dd, Dd, Dd, Dd, Dd, Hd, Dd, Hd, Hd, Dd, Dd, Dd^Esd, Dd, Dd, Dd, Hd, Hd, Mdd, Hd, Dd, Dd^Edb, Dd^Edb, Dd^Edb, Hd, Dd, Hd, Dd, Dd, Dd, Rd, Rd, Cd, Cd, 2 Kd, Rd, Rd, Dd, Dd^Vda, Hd, Hd, Hd, Hd
Dd, Dd, Dd, Dd, Dd, Hd, Hd, Hd, Hd, Hd, Dd^Esd, Dd, Dd, Dd, Dd^Esd, Dd^Esd, Hd, Hd, Hd, Hd, Hd, Dd, Dd, Dd^Edpp, Dd, Hd, Hd, Hd, Dd, Dd, Rd, Kd, Rd, Cdr, Rd, Cd, Rd, Dd, Dd, Hd, Hd, Hd, Hd
Dd, Dd, Dd, Dd, Hd, Hd, Hd, Hd, Hd, Dd, Dd, Dd, Dd, Dd, Dd, Hd, Hd, Mdd, Hd, Hd, Dd, Dd, Dd, Dd, Hd, Hd, Hd, Hd, Hd, Dd^Edpp, Dd, Rd, Dd^Vda, Rd, Dd, Rd, Dd, Rd, Rd, Dd^Edp, Dd, Hd, Hd
Dd, Dd, Dd, Hd, Hd, Hd, Hd, Hd, Hd, Dd, Dd, Dd, Dd, Dd, Hd, Hd, Mdd, Mdd, Hd, Hd, Dd, Dd, Dd, Dd, Dd, Hd, Hd, Hd, Hd, Hd, Hd, Hd, Hd, Dd, Hd, Dd, Dd, Dd, Rd, Dd, Dd, Hd, Dd
Dd, Dd, Hd, Hd, Hd, Hd, Hd, Hd, Hd, Hd, Hd, Dd, Dd, Dd, Hd, Hd, Mdd, Mdd, Hd, Hd, Dd, Dd, Dd, Dd, Dd, Hd, Dd, Hd, Dd, Hd, Hd, Hd, Hd, Hd, Dd^Esd, Hd, Dd^Dc, Dd, Dd, Rd, Dd, Dd, Dd^Esd
