Dd, Dd, Dd, Dd, Dd^Esd, Dd^Esd, Hd, Hd, Hd, Dd, Hd, Dd, Hd, Hd, Dd^Ftd, Dd^Ftd, Dd^Ftd, Dd, Dd, Dd, Rd
Dd, Dd, Dd, Dd, Dd, Dd, Dd, Hd, Dd, Hd, Hd, Hd, Dd^Ftd, Hd, Rd, Rd, Rd, Rd, 3 Rd, Rd, Dd
Rd, Rd, Rd, Rd, Rd, Rd, Rd, Rd, Rd, Dd, Dd^Vda, Dd^Ftd, Rd, Rd, Hd, Dd, Hd, Dd, Dd, Dd^Ftd, Dd
Hd, Dd, Hd, Dd, Hd, Dd, Hd, Dd^Dc, Rd, Dd, Dd, Dd, Rd, Dd^Ftd, Dd, Hd, Hd, Hd, Hd, Hd, Hd
Mdd, Hd, Hd, Hd, Hd, Hd, Dd, Dd, Dd, Rd, Rd, Rd, Dd, Dd, Dd^Ftd, Hd, Dd^Ftd, Hd, Mdd, Mdd, Mdd
Mdd, Mdd, Hd, Hd, Hd, Hd, Dd, Dd, Hd, Dd, Dd, Dd, Hd, Dd, Dd^Esd, Dd^Ftd, Dd^Fts, Dd^Fts, Hd, Mdd, Mdd
Hd, Hd, Dd^Edp, Dd^Esd, Dd, Dd, Dd, Hd, Hd^Cov, Dd, Dd^Cov, Hd^Cov, Hd^Cov, Ds, Dd, Dd, Dd^Fts, Dd^Fts, Dd^Ftd, Hd, Dd
Dd, Hd, Dd, Dd, Dd^Ftd, Dd^Ftd, Dd, Ds^Kov, Hd^Cov, Dd^Cov, Hd^Esd, Hd, Dd^Esd, Dd^Cov, Dd^Cov, Ds, Ds, Dd^Fts, Dd^Ftd, Hd, Dd^Esd
Dd, Dd, Dd, Dd, Dd, Dd^Fts, Ds, Dd^Cov, Dd^Cov, Dd^Esd, Dd, Dd^Esd, Dd^Esd, Dd, Hd^Cov, Hd, Hd, Dd, Dd^Ftd, Dd, Dd
Hd, Hd, Hd, Hd, Dd, Dd, Dd, Ds^Esd, Dd^Cov, Dd^Esd, Dd, Sm, 2 Dd^Esd, Hd, Dd^Cov, Hd, Dd, Dd, Dd, Dd, Dd
Hd, Hd, Hd, Dd, Dd^Fts, Ds, Dd, Hd, Hd^Cov, Hd, Dd^Esd, Dd^Esd, Hd, Dd^Esd, Dd^Cov, Hd, Dd, Dd, Dd, Dd, Dd
Dd, Hd, Dd, Dd^Ftd, Dd^Fts, Dd^Fts, Dd, Hd, Hd, Dd^Cov, Dd^Cov, Hd, Hd^Cov, Hd^Cov, Hd, Dd, Ds, Dd, Hd, Hd, Dd
Dd, Dd^Edp, Dd, Dd, Dd^Ftd, Dd^Vdr, Dd, Dd, Ds, Dd, Dd, Dd^Cov, Dd, Hd, Dd, Dd, Ds, Dd^Edp, Dd, Hd, Dd
Dd, Dd, Dd, Dd, Dd, Dd, Dd^Esd, Ds, Dd, Dd, Dd, Dd, Ds, Ds, Dd, Dd, Dd, Dd, Dd^Ftd, Dd, Dd
Hd, Hd, Hd, Hd, Hd, Hd, Hd, Dd, Hd, Dd, Dd, Dd, Dd, Ds, Dd, Dd, Dd, Dd^Vdr, Dd, Dd, Dd
Dd, Hd, Dd, Hd, Hd, Hd, Hd, Hd, Hd, Hd, Dd, Dd^Esd, Dd^Esd, Dd^Esd, Dd, Dd, Hd, Dd, Dd, Dd, Dd^Esd
Dd, Dd, Dd, Dd, Dd, Dd, Dd, Dd, Dd, Dd, Dd, Dd, Hd, Hd, Hd, Hd, Hd, Hd, Hd, Hd, Hd
Dd, Dd, Dd, Dd, Dd, Dd, Dd^Esd, Dd, Dd, Dd, Dd, Dd, Hd, Hd, Hd, Hd, Hd, Hd, Hd, Hd, Hd
Dd, Dd, Dd^Esd, Dd, Dd, Dd, Dd, Dd, Dd, Dd^Edpp, Dd, Dd, Dd, Dd, Dd, Dd, Dd^Esd, Hd, Dd, Hd, Hd
Dd, Dd, Hd, Hd, Hd, Dd, Hd, Dd, Hd, Dd^Esd, Dd, Dd, Dd, Dd, Dd, Dd, Dd^Dc, Dd, Dd, Dd, Dd
Dd, Dd, Dd, Hd, Hd, Hd, Hd, Hd, Hd, Hd, Hd, Dd, Dd, Dd, Dd, Dd, Dd, Dd, Dd, Dd, Dd
Dd^Edpp, Dd, Dd, Dd^Esd, Dd, Dd, Dd^Edb, Dd^Vdt, Dd^Edb, Dd, Dd, Dd, Dd, Dd, Dd^Esd, Dd, Dd, Dd, Dd, Dd, Dd
Hd, Hd, Dd, Dd, Dd, Dd, Dd, Dd^Edb, Dd^Edp, Dd, Dd, Dd, Hd, Hd, Hd, Dd, Hd, Dd, Dd, Dd, Dd
Hd, Hd, Hd, Hd, Hd, Dd, Hd, Dd, Hd, Dd, Dd, Dd, Dd, Hd, Dd^Edp, Hd, Hd, Hd, Hd, Hd, Hd
Dd^Edp, Hd, Hd, Hd, Hd, Hd, Hd, Hd, Hd, Hd, Hd, 1 Dd, Dd, Dd, Dd^Esd, Hd, Dd, Hd, Hd, Hd, Hd
Dd, Dd, Dd, Dd, Dd, Hd, Dd, Hd, Dd, Hd, Dd, Dd^Esd, Dd, Dd, Dd, Dd, Dd, Dd, Dd, Dd, Dd^Esd
Dd, Dd^Dc, Dd, Dd, Dd, Dd, Dd, Dd, Dd, Dd, Dd, Dd, Dd, Dd, Dd, Dd, Dd, Dd, Dd, Dd, Dd
