Hd, Hd, Hd, Hd, Hd, Hd, Hd, Dd, Dd, Dd, Ds, Hd, Mdd, Mdd, Mdd, Mdd, Mdd, Mdd, Hd, Dd, Hd, Hd, Hd, Hd, Hd, Mdd, Mdd, Mdd^Xm, Mdd^Xm, Mdd^Xm, Mdd, Mdd, Mdd, Gd, Gd, Rd, Gd, Gd^Fts, Gd^Fts, Mdd, Mdd, Mdd, Mdd
Hd, Hd, Hd, Hd, Hd, Hd, Hd, Dd, Dd, Dd, Ds, Ds, Mdd, Mdd, Hd, Mdd, Hd, Mdd, Hd, Hd, Hd, Hd, Hd, Hd, Mdd, Mdd, Mdd, Mdd^Xm, Mdd^Xm, Mdd, Mdd, Mdd, Hhd, Hhd, Gd, Rd, Gd^Fts, Gd^Fts, Mdd, Mdd, Mdd, Mdd, Mdd
Hd, Hd, Hd, Hd, Dd, Hd, Dd, Dd, Dd, Ds, Hd, Mdd, Mdd, Mdd, Hd, Hd, Dd, Hd, Dd, Hd, Hd, Hd, Hd, Hd, Hd, Mdd, Mdd^Xm, Mdd^Xm, Mdd, Mdd, Hhd, Mdd, Hhd, Gd^Vda, Rd, Rd, Gd^Fts, Gd^Fts, Mdd, Mdd, Mdd, Mdd, Ds
Hd, Hd, Hd, Hd, Hd, Dd, Dd^Edb, Dd, Dd, Hd, Hd, Hd, Hd, Hd, Hd, Dd, Dd^Vdt, Ds, Hd, Mdd, Mdd, Mdd, Mdd, Mdd, Mdd, Mdd, Mdd^Xm, Mdd^Xm, Mdd, Hhd, Hhd, Hhd, Hhd, Gd, Rd, Gd, Hhd, Mdd, Mdd, Mdd, Ds^Es, Dd, Dd
Hd, Hd, Hd, Hd, Hd, Dd, Dd^Vdt, Hd, Mdd, Hd, Mdd, Mdd, Ds, Ds, Dd, Dd^Edb, Dd^Edb, Dd, Mdd, Mdd, Hd, Mdd, Mdd, Mdd, Mdd, Mdd, Mdd^Xm, Mdd, Hhd, Hhd, Hhd, Hhd, Cd, 3 Kd, Cd, Gd, Hhd, Mdd, Hhd, Mdd, Ds^Es, Dd^Es, Dd
Hd, Hd, Hd, Hd, Hd, Dd^Edb, Dd^Edb, Hd, Hd, Mdd, Mdd, Hd, Hd, Ds, Dd, Dd, Hd, Hd, Hd, Mdd, Hd, Hd, Ds, Ds, Mdd, Mdd, Mdd, Mdd, Mdd, Hhd, Hhd, Kd, Cd, Cd, Cd, Kd, Gd, Hhd, Gd^Fts, Dd, Dd, Ds, Dd
Hd, Dd, Dd, Dd, Dd, Dd, Dd, Hd, Hd, Mdd, Hd, Hd, Dd, Dd, Dd, Dd, Dd, Dd, Dd, Hd, Hd, Dd^Dc, Ds, Ds, Mdd, Mdd, Mdd, Mdd, Hhd, Hhd, Hhd, Rd, Rd, Kd, Rd, Rd, Rd, Gd^Vda, Gd^Fts, Gd^Fts, Hhd, Mdd, Mdd
Hd, Hd, Dd, Dd, Dd, Dd, Dd, Hd, Ds, Hd, Dd, Hd, Dd, Dd, Ds, Dd, Hd, Dd^Edpp, Dd, Hd, Dd, Dd, Hd, Mdd, Hd, Mdd, Mdd, Mdd, Hhd, Hhd, Gd, Cd, Rd, Rd, Rd, Cd, Gd, Gd, Gd, Hhd, Mdd, Mdd, Mdd^Xm
Hd, Dd, Dd, Dd, Hd, Dd, Dd, Dd, Ds, Ds, Dd, Dd^Edp, Dd, Dd, Ds, Hd, Hd, Dd, Dd, Dd^Edb, Dd^Vdt, Dd, Hd, Hd, Hd, Mdd, Mdd, Mdd, Hhd, Gd, Gd^Vda, Gd, Rd, Rd, Gd, Rd, Gd, Gd^Fts, Gd^Fts, Hhd, Mdd, Mdd, Mdd^Xm
Dd, Dd^Edp, Dd, Hd, Hd, Dd, Dd, Dd, Hd, Dd, Dd, Dd^Vdt, Dd^Edb, Ds, Hd, Mdd, Hd, Dd, Hd, Dd^Esd, Dd^Esd, Dd^Edb, Dd, Hd, Mdd, Mdd, Hhd, Hhd, Hhd, Gd, Gd, Rd, Rd, Gd, Hhd, Hhd, Hhd, Gd^Fts, Ds, Hhd, Mdd, Mdd, Mdd
Dd, Dd, Hd, Hd, Dd, Dd, Dd, Dd, Hd, Dd, Dd, Dd^Edb, Dd, Hd, Hd, Mdd, Mdd, Hd, Dd, Dd, Dd, Dd, Ds, Ds, Dd, Mdd, Ds^Es, Dd, Hhd, Hhd, Gd, Rd, Gd, Gd^Fts, Hhd, Mdd, Mdd, Ds, Dd, Hhd, Mdd, Mdd, Mdd
Dd, Hd, Hd, Hd, Dd, Dd, Hd, Hd, Hd, Dd, Dd, Dd, Ds, Ds, Mdd, Mdd, Hd, Hd, Ds, Dd, Dd, Hd, Hd, Dd, Mdd, Ds^Es, Dd, Ds, Rd, Gd, Gd, Rd, Gd^Fts, Gd^Fts, Mdd, Mdd, Dd^Es, Dd^Es, Dd, Mdd, Mdd, Mdd, Dd
Dd, Hd, Hd, Dd, Dd^Vo, Dd, Hd, Hd, Hd, Dd, Dd, Dd, Ds, Hd, Mdd, Mdd, Hd, Ds, Ds, Dd, Dd^Edp, Dd, Hd, Mdd, Mdd, Hhd, Hhd, Hhd, Hhd, Gd, Gd, Rd, Gd^Fts, Gd^Fts, Hhd, Hhd, Gd^Fts, Ds^Es, Mdd, Mdd, Mdd, Dd, Dd
Dd, Dd, Dd, Dd^Esd, Rd^Edb, Rd, 4 Ko, Hd, Hd, Hd, Dd, Dd^Edp, Dd, Hd, Hd, Hd, Hd, Ds^Esd, Dd, Hd, Hd, Hd, Hhd, Mdd, Mdd, Mdd, Hhd, Hhd, Gd, Gd^Vda, Rd, Rd, Gd, Gd, Gd^Fts, Gd^Fts, Hhd, Hhd, Mdd, Mdd, Dd^Es, Dd, Ds
Rd, Dd, Rd, Dd, Rd, Ko, Co, Co, Cer, Rd, Dd^Vo, Dd, Dd, Dd, Hd, Hd, Dd, Dd, Dd, Dd, Hd, Hd, Mdd, Mdd, Hhd, Mdd, Hhd, Gd, Gd, Gd, Rd, Rd, Gd, Gd, Hhd, Gd^Fts, Hhd, Mdd, Mdd, Dd^Es, Dd, Dd^Es, Mdd
Dd, Rd, Dd, Rd, Rd, Co, Cer, Cer, Rd^Edb, Rd^Edb, Dd^Edb, Dd^Edb, Dd^Edp, Dd, Dd^Dc, Dd, Dd^Edb, Dd^Vdr, Dd^Edb, Dd, Hd, Hhd, Mdd, Mdd, Hhd, Hhd, Gd, Gd, Cdr, Gd, Rd, Gd, Gd^Fts, Gd^Fts, Gd^Fts, Hhd, Mdd, Mdd, Ds^Es, Ds, Hhd, Mdd, Mdd
Dd, Dd, Dd, Dd^Vo, Rd^Edb, Cer, Rd^Edb, Rd, Rd, Dd^Edb, Dd, Dd, Dd, Dd, Hd, Dd, Dd, Dd^Edb, Dd, Hhd, Hhd, Mdd, Hhd, Hhd, Hhd, Gd, Gd, Ds, Ds, Rd, Rd, Gd, Gd, Gd^Fts, Gd^Fts, Hhd, Dd, Ds, Ds, Hhd, Mdd, Mdd, Mdd
Dd, Dd, Dd^Esd, Dd^Edb, Dd, Rd, Dd^Edb, Dd^Edb, Dd, Rd, Dd, Dd, Hd, Hd, Dd, Dd, Dd, Dd, Mdd, Hhd, Gd, Hhd, Gd, Hhd, Ds, Gd, Dd, Ds, Dd, Rd, Dd, Cdr, Ds, Gd, Gd^Fts, Gd, Gd, Rd, Hhd, Hhd, Mdd, Mdd, Mdd
Dd, Dd, Dd^Vo, Dd, Dd, Dd, Hd, Hd, Dd, Rd, Dd, Dd, Hd, Hd, Dd, Dd, Ds^Es, Mdd, Mdd, Hhd, Gd, Gd, Rd, Ds, Ds, Dd, Dd^Vda, Dd, Rd, Rd, Dd, Dd^Dc, Ds, Rd, Rd, Gd^Vda, Hhd, Gd, Hhd, Mdd, Hhd, Hhd, Mdd
Dd, Dd, Dd, Dd^Edb, Hd, Hd, Hd, Dd, Rd, Rd^Edb, Dd^Vo, Hd, Hd, Dd^Dc, Dd, Ds, Mdd, Mdd, Hhd, Hhd, Hhd, Ds, Dd, Dd, Dd, Dd, Dd, Rd, Dd, Dd, Dd, Ds, Dd, Ds, Rd, Gd, Ds, Hhd, Hhd, Hhd, Hhd, Mdd, Mdd
Dd, Dd, Dd, Dd, Hd, Hd, Hd, Dd, Rd, Dd^Edb, Hd, Hd, Dd, Dd, Dd, Ds^Es, Mdd, Hhd, Hhd, Dd, Dd, Dd, Dd, Dd, Rd, Dd, Rd, Rd, Dd, Dd, Dd^Edpp, Dd, Dd^Ftd, Dd, Dd, Ds, Ds, Hhd, Gd, Hhd, Hhd, Hhd, Hhd
Hd, Hd, Hd, Hd, Hd, Hd, Dd, Dd^Do, Rd, Dd, Rd, Rd, Rd, Dd^Esd, Dd, Mdd, Hhd, Hhd, Hhd, Dd, Dd, Dd, Rd, Rd, Ce, Rd, Rd, Dd, Dd^Edpp, Dd^Ftd, Dd^Ftd, Dd^Ftd, Dd^Ftd, Dd, Dd, Dd, Rd, Gd, Gd, Gd, Hhd, Hhd, Hhd
Hd, Hd, Hd, Hd, Hd, Dd, Dd, Dd, Dd, Rd, Dd, Dd, Dd, Rd, Dd, Hhd, Hhd, Dd, Dd, Dd, Dd, Dd, Rd, Ce, 1 Ke, Ce, Rd, Dd, Dd, Dd^Edpp, Dd^Ftd, Dd^Do, Dd^Ftd, Dd^Ftd, Dd, Dd^Dc, Ds, Ds, Ds, Ds, Gd, Hhd, Hhd
Hd, Hd, Hd, Hd, Dd, Dd, Dd, Dd, Dd, Dd, Hd, Hd, Dd, Rd, Rd, Hhd, Rd, Rd, Rd, Rd, Rd, Rd, Rd, Ce, Ce, Ce, Rd, Dd, Dd, Dd^Ftd, Dd, Dd^Ftd, Dd^Vda, Dd^Edpp, Dd^Edpp, Dd, Dd, Dd, Dd, Ds, Rd, Hhd, Ds
Hd, Hd, Dd, Dd, Dd^Edb, Dd^Vdr, Dd^Edb, Dd, Dd, Hd, Hd, Hd, Dd, Dd, Dd, Rd, Dd, Rd, Dd, Dd, Hd, Dd, Dd, Rd, Rd, Rd, Dd, Rd, Rd, Dd, Dd, Dd, Dd, Dd, Dd, Dd, Dd, Dd, Dd, Dd, Dd, Gd, Ds
Dd, Hd, Dd, Dd, Dd, Dd^Edb, Dd, Dd, Hd, Hd, Hd, Hd, Dd, Dd, Dd, Dd, Dd, Dd^Esd, Dd, Dd^Edp, Hd, Hd, Dd, Dd, Dd, Dd, Dd, Dd, Dd^Edp, Rd, Rd, Rd, Rd, Rd, Rd, Rd, Rd, Dd, Dd, Dd, Dd^Edpp, Ds, Ds
Dd, Dd, Dd, Dd, Dd, Dd, Dd, Hd, Hd, Hd, Hd, Hd, Dd, Dd, Dd^Edb, Dd^Vdr, Dd^Edb, Dd, Hd, Hd, Hd, Hd, Hd, Dd, Dd, Dd, Dd, Dd, Dd^Edp, Dd, Rd, Cd, Kd, Cd, Cd, Kd, Rd, Dd, Hd, Dd, Hd, Dd, Dd
Dd, Dd, Dd, Dd, Dd, Dd, Hd, Hd, Hd, Hd, Hd, Dd, Dd, Dd, Dd, Dd^Edb, Dd, Dd, Hd, Hd, Dd^Dc, Dd, Dd^Vdr, Dd, Dd, Dd, Dd, Dd, Dd^Vda, Dd^Esd, Dd, Rd, Cd, Cd, Cd, Rd, Dd, Dd, Hd, Hd, Hd, Dd^Esd, Dd
Dd, Dd, Dd, Dd, Dd, Hd, Hd, Hd, Hd, Hd, Dd, Dd, Dd^Esd, Dd, Dd, Dd, Dd, Hd, Hd, Hd, Dd, Dd^Edb, Dd^Edb, Dd^Edb, Hd, Dd, Hd, Dd, Dd, Dd, Rd, Rd, Cd, Cd, 2 Kd, Rd, Rd, Dd, Dd^Vda, Hd, Hd, Hd, Hd
Dd, Dd, Dd, Dd, Dd, Hd, Hd, Hd, Hd, Hd, Dd^Esd, Dd, Dd, Dd, Dd^Esd, Dd^Esd, Hd, Hd, Hd, Hd, Hd, Dd, Dd, Dd^Edpp, Dd, Hd, Hd, Hd, Dd, Dd, Rd, Kd, Rd, Cd, Rd, Cd, Rd, Dd, Dd, Hd, Hd, Hd, Hd
Dd, Dd, Dd, Dd, Hd, Hd, Hd, Hd, Hd, Dd, Dd, Dd, Dd, Dd, Dd, Dd, Hd, Hd, Hd, Hd, Dd, Dd, Dd, Dd, Hd, Hd, Hd, Hd, Hd, Dd^Edpp, Dd, Rd, Dd, Rd, Dd, Rd, Dd, Rd, Rd, Dd^Edp, Dd, Hd, Hd
Dd, Dd, Dd, Hd, Hd, Hd, Hd, Dd^Esd, Dd, Dd, Dd, Dd, Dd, Dd, Hd, Hd, Hd, Hd, Hd, Hd, Dd, Dd, Dd, Dd, Dd, Hd, Hd, Hd, Hd, Hd, Hd, Hd, Hd, Dd, Hd, Dd, Dd, Dd, Rd, Dd, Dd, Hd, Dd
Dd, Dd, Hd, Hd, Hd, Hd, Dd^Edpp, Dd, Dd^Esd, Dd, Dd^Do, Dd, Dd, Dd, Dd, Hd, Hd, Hd, Dd, Dd^Esd, Dd, Dd, Dd, Dd, Dd, Hd, Dd, Hd, Dd, Hd, Hd, Hd, Hd, Hd, Dd^Esd, Hd, Dd^Dc, Dd, Dd, Rd, Dd, Dd, Dd^Esd
